;=
;= Aliases for use with doskey
;=
;= To apply run:
;=   doskey /macrofile=%HOME%\scripts\aliases.txt
;=
cd=c:\home\simon\scripts\cd.cmd $*
cds=cd %HOME%\scripts
cdp=cd %HOME%\projects
cdh=cd %HOME%\projects\hmstr
clear=cls
e.=explorer .
fs=findstr $*
ga=git add $*
gb=git branch $*
gc=git commit $*
gd=git diff $*
gdt=git difftool $*
gf=git fetch $*
glo=git log --oneline $*
gm=git merge $*
gmom=git merge origin main $*
gprom=git pull --rebase origin main
gr=git rebase $*
grom=git rebase origin main $*
gs=git status $*
gpo=git stash pop
gpu=git stash push
gsw=git switch $*
ll=ls -la --color $*
lp=tasklist | findstr $*
sshr=ssh $1 -R 52698:127.0.0.1:52698
subl="/Program Files/Sublime Text/sublime_text.exe" $*
tl=tasklist $*
